####################################
#                                  #
#                                  #
#                                  #
#                                  #
#          #####                   #
#                                  #
#                                  #
#                                  #
#                                  #
#                                  #
#                                  #
#                                  #
#                                  #
#                   #####          #
#                                  #
#                                  #
#                                  #
#          #                       #
#          #                       #
#          #                       #
#          #             ######    #
#          #                       #
#                                  #
#                                  #
#                                  #
#                                  #
#                        #         #
#                        #         #
#                        #         #
####################################